agarza = agarza <agarza>
alindeman = alindeman <alindeman>
andy_st = andy_st <andy_st>
austin2k = austin2k <austin2k>
baschny = baschny <baschny>
beckettmw = beckettmw <beckettmw>
bharat = bharat <bharat>
ckdake = ckdake <ckdake>
cryptographite = cryptographite <cryptographite>
dcau = dcau <dcau>
deerwood = deerwood <deerwood>
dhalbrook = dhalbrook <dhalbrook>
dmolavi = dmolavi <dmolavi>
donwillingham = donwillingham <donwillingham>
dpk = dpk <dpk>
frederikkunz = frederikkunz <frederikkunz>
fryfrog = fryfrog <fryfrog>
h0bbel = h0bbel <h0bbel>
jackodog = jackodog <jackodog>
jadeadragon = jadeadragon <jadeadragon>
jefmcg = jefmcg <jefmcg>
jenst = jenst <jenst>
jmullan = jmullan <jmullan>
john_kirkland = john_kirkland <john_kirkland>
jonhuang5 = jonhuang5 <jonhuang5>
jozefs = jozefs <jozefs>
mceachen = mceachen <mceachen>
mindless = mindless <mindless>
muti = muti <muti>
(no author) = (no author) <(no author)>
paour = paour <paour>
rizzo = rizzo <rizzo>
root = root <root>
rossr = rossr <rossr>
schultmc = schultmc <schultmc>
sgartner = sgartner <sgartner>
shadowstrider = shadowstrider <shadowstrider>
spiderr = spiderr <spiderr>
tango__ = tango__ <tango__>
thumb70 = thumb70 <thumb70>
tim_miller = tim_miller <tim_miller>
uid56782 = uid56782 <uid56782>
virshu = virshu <virshu>
volksport = volksport <volksport>
walkah = walkah <walkah>
